5  -1 -1 -1 -1 -1 -1 -1 -1 -1 -1 -1  6  5 -1 -1 -1 -1  6
5  -1 -1 -1 -1 -1 -1 -1 -1 -1 -1 -1  6 11  3  7 -1 -1  6
5  -1 -1 -1 -1 -1  8  7 -1 -1 -1 -1 10  4 14  5 -1 -1  6
5  -1 -1 -1 -1 -1  6  5 -1 -1 -1 -1 -1 -1  6  5 -1 -1  6
5  -1 -1 -1 -1 -1  6  5 -1 -1 -1 -1 -1 -1  6  5 -1 -1  6
5  -1 -1 -1 -1 -1  6  5 -1 -1 -1 -1 -1 -1  6  5 -1 -1  6
11  3  7 -1  8  3 13 11  3  3  3  3  3  3 13  5 -1 -1  6
12  4  9 -1 10 14 12  4  4  4  4 14 12  4  4  9 -1 -1  6
5  -1 -1 -1 -1  6  5 -1 -1 -1 -1  6  5 -1 -1 -1 -1 -1  6
5  -1 -1 -1 -1  6  5 -1 -1 -1 -1  6  5 -1 -1 -1 -1 -1  6
5  -1 -1 -1 -1  6  5 -1 -1 -1 -1  6  5 -1 -1 -1 -1 -1  6
5  -1 -1 -1 -1  6  5 -1 -1 -1 -1  6  5 -1 -1 -1 -1 -1  6
5  -1 -1 -1 -1 10  9 -1 -1 -1 -1 10  9 -1 -1 -1 -1 -1  6
5  -1 -1 -1 -1 -1 -1 -1 -1 -1 -1 -1 -1 -1 -1 -1 -1 -1  6
5  -1 -1 -1 -1 -1 -1 -1 -1 -1 -1 -1 -1 -1 -1 -1 -1 -1  6
11  3  3  3  3  3  3  3  3  3  3  3  3  3  3  3  3  3 13
-1 -1 -1 -1 -1 -1 -1 -1 -1 -1 -1 -1 -1 -1 -1 -1 -1 -1 -1
